#####################
#   A       1234    #
# #### # ### # #### #
#A#  #A#     #A#  # #
# #### # # # # #### #
#      # # #A#      #
# #### # # # # #### #
#A#             A # #
# # ######A###### # #
#   A           A   #
# #### # ### # #### #
# #  # #  A  # #  # #
#A#### # ### # ####A#
#     A#  A  #A     #
# #### # ### # #### #
#         A         #
#####################